W1W1W1W1+0R0R0R0R0W0
W1W1W1W1-0R0R0R0R0W0
W1W1W1W1-0R0R0R0R0W0
L2L2L2-0-0-0-0-0-0-0
L2L2L2-0A3A3A3A3L3L3
L2L2L2-0A3A3A3A3L3L3
L0L0L0-0A3A3A3A3W3W3
P0P0P0-0A4A4A4A4W4W4
P0P0P0-0-0-0-0-0-0=0
P0P0P0-0R0R0R0R0-0L0
