20
20
9
L1L1W1W1-0R0R0R0R0W0W0P0P0P0P0-0A2A2A2A2
L1W1W1W1-0R0R0R0R0W0W0P0P0P0P0-0A2A2A2A2
L1L1W1W1-0R0R0R0R0W0W0P0P0P0P0-0A2A2A2A2
L3L3L3-0-0-0-0-0-0-0-0-0-0-0-0-0-0-0-0=0
L3L3L3-0-0L4L4L4-0-0-0-0-0-0L5A5A5-0-0L0
+0-0-0-0-0L4L4L4-0P0P0L5L5L5L5L5A5-0-0=0
+0-0-0-0-0L4L4L4-0P0P0L5L5L5L5L5W5-0L6L6
P0P0P0-0-0L4L4L4-0P0P0L5L5L5L5L5W5-0L6W6
P0P0P0-0-0-0-0-0-0P0P0P0P0P0W5W5W5-0L6W6
P0P0P0-0-0R0R0R0-0P0P0P0P0P0-0-0-0-0L6L6
L0L0L0-0-0R0R0R0-0-0-0-0-0-0-0-0-0-0-0=0
R0R0R0-0-0R0R0R0-0L7L7L7W7L7L7L7L7-0P0P0
R0R0R0-0-0R0R0R0-0L7L7W7W7W7W7L7L7-0P0P0
R0R0R0-0-0R0R0R0-0L7L7L7W7L7L7L7L7-0P0P0
R0R0R0-0-0-0-0-0-0-0-0-0-0-0-0-0-0-0P0P0
+0-0-0-0-0-0-0-0-0-0-0-0-0-0-0-0-0-0-0=0
P0P0P0P0W8W8W8W8-0L9L9L9L9-0R0R0R0R0R0R0
P0P0P0P0W8W8W8W8-0L9L9L9L9-0R0R0R0R0R0R0
P0P0P0P0W8W8W8W8-0L9L9L9L9-0R0R0R0R0R0R0
P0P0P0P0W8W8W8W8-0L9L9L9L9-0R0R0R0R0R0R0
