20
20
9
W1W1W1W1+0R0R0R0R0W0W0P0P0P0P0-0A2A2-0-0-0-0-0
W1W1W1W1-0R0R0R0R0W0W0P0P0P0P0-0A2A2-0R0R0R0R0
W1W1W1W1-0R0R0R0R0W0W0P0P0P0P0-0A2A2-0R0R0R0R0
L3L3L3-0-0-0-0-0-0-0-0-0-0-0-0-0-0-0-0R0R0R0R0
L3L3L3-0-0A4A4A4-0-0-0-0-0-0A5A5A5-0-0R0R0R0R0
L3L3L3-0-0A4A4A4-0P0P0P0P0P0A5A5A5-0-0-0-0-0-0
-0-0-0-0-0A4A4A4-0P0P0P0P0P0A5A5A5-0-0L6L6L6L6
P0P0P0-0-0A4A4A4-0P0P0P0P0P0A5A5A5-0-0L6W6W6L6
P0P0P0-0-0-0-0-0-0P0P0P0P0P0A5A5A5-0-0L6W6W6L6
P0P0P0-0-0R0R0R0-0P0P0P0P0P0-0-0-0-0-0L6L6L6L6
L0L0L0-0-0R0R0R0-0-0-0-0-0-0-0-0-0-0-0L0L0L0L0
R0R0R0-0-0R0R0R0-0L7L7L7L7L7L7L7L7-0-0P0P0P0P0
R0R0R0-0-0R0R0R0-0L7L7L7W7W7L7L7L7-0-0P0P0P0P0
R0R0R0-0-0R0R0R0-0L7L7L7L7L7L7L7L7-0-0P0P0P0P0
R0R0R0-0-0-0-0-0-0-0-0-0-0-0-0-0-0-0-0P0P0P0P0
-0-0-0-0-0-0-0-0-0-0-0-0-0-0-0-0-0-0-0-0-0-0=0
P0P0P0P0W8W8W8W8W0A9A9A9A9-0R0R0R0R0L0L0L0W0W0
P0P0P0P0W8W8W8W8W0A9A9A9A9-0R0R0R0R0L0L0L0W0W0
P0P0P0P0W8W8W8W8W0A9A9A9A9-0R0R0R0R0L0L0L0W0W0
P0P0P0P0W8W8W8W8W0A9A9A9A9-0R0R0R0R0L0L0L0W0W0
